TITLE: A cool level
MAP: 15 8
4 8 2 1 1 1 1 1 1 1 1 1 1 1 7
3 0 0 0 0 0 0 0 1 0 0 0 0 0 2
2 0 0 1 0 0 0 0 1 0 0 0 0 0 1
1 0 0 1 1 1 1 0 1 0 1 0 1 1 1
1 0 0 0 0 0 0 0 0 0 1 0 1 0 1
1 1 2 0 1 1 0 1 1 1 1 2 1 0 1
1 0 0 0 1 0 0 0 0 0 0 0 0 0 1
6 1 1 1 1 1 1 1 1 2 1 1 1 1 9
